12 x 17
*****************
*              H*
*R              *
*               *
*    R     *    *
*  *     ** *R  *
*   R           *
*    *  *     * *
* *       R     *
*               *
*       *       *
*****************